407 407 407 407 407 407 407 407 407 407 407 407 407 407 407 407 407 407 407 407 407 407 407 407 407 407 407 407 407 407 407 407 407 407 407 407 407 407 407 407 407 407 407 407 407 407 407 407 407 407 
407 407 407 407 407 407 407 407 407 407 407 407 407 407 407 407 407 407 407 407 407 407 407 407 407 407 407 407 407 407 407 407 407 407 407 407 407 407 407 407 407 407 407 407 407 407 407 407 407 407 
407 407 407 407 407 407 407 407 407 407 407 407 407 407 407 407 407 407 407 407 407 407 407 407 407 407 407 407 407 407 407 407 407 407 407 407 407 407 407 407 407 407 407 407 407 407 407 407 407 407 
407 407 407 407 407 407 407 407 408 407 407 407 407 407 407 407 407 407 407 407 407 407 407 407 407 407 407 407 407 407 407 407 407 407 407 407 407 407 407 407 407 407 407 407 407 407 407 407 407 407 
407 407 407 407 407 407 407 407 407 407 407 407 407 407 407 407 407 407 407 407 407 407 407 407 407 407 407 407 407 407 407 407 407 407 407 407 407 407 407 407 407 407 407 407 407 407 407 407 407 407 
407 407 407 407 407 407 407 407 407 407 407 407 407 407 407 407 407 407 407 407 407 407 407 407 407 407 407 407 407 407 407 407 407 407 407 407 407 407 407 407 407 407 407 407 407 407 407 407 407 407 
407 407 407 407 407 407 407 407 372 373 373 373 373 373 373 373 373 373 373 373 373 373 373 373 373 373 373 373 373 373 373 373 373 373 373 373 373 373 373 373 373 375 407 407 407 407 407 407 407 407 
407 407 407 407 407 407 407 407 440 217 217 276 277 156 156 156 156 156 433 156 156 217 217 217 217 217 217 217 217 217 217 217 217 217 217 217 217 217 217 217 217 436 407 407 407 407 407 407 407 407 
407 407 407 407 407 407 407 407 440 277 277 870 870 277 277 277 277 156 404 156 156 156 156 156 156 156 156 156 217 217 217 217 217 217 217 217 217 217 217 217 217 436 407 407 407 407 407 407 407 407 
407 407 407 407 407 407 407 407 440 217 870 870 870 870 277 277 277 277 277 277 156 156 403 156 156 156 156 156 217 217 217 217 217 217 217 217 217 217 217 217 217 436 407 407 407 407 407 407 407 407 
407 407 407 407 407 407 407 407 440 870 870 870 277 870 870 277 277 277 277 277 277 277 277 277 277 277 156 156 217 217 217 217 217 217 217 217 217 217 217 217 217 436 407 407 407 407 407 407 407 407 
407 407 407 407 407 407 407 407 440 217 870 870 870 870 277 277 277 277 277 277 277 277 277 277 277 277 277 277 217 217 217 217 217 217 217 217 217 217 217 217 217 436 407 407 407 407 407 407 407 407 
407 407 407 407 407 407 407 407 440 217 277 277 870 277 277 277 277 404 156 277 277 156 433 156 217 217 217 217 217 217 217 217 217 217 217 217 217 156 156 156 156 435 407 407 407 407 407 407 407 407 
407 407 407 407 407 407 407 407 440 217 217 156 217 217 217 217 277 277 277 277 217 217 217 217 217 217 217 217 217 217 217 217 217 217 217 217 217 527 528 529 156 436 407 407 407 407 407 407 407 407 
407 407 407 407 407 407 407 407 462 463 463 463 463 463 463 463 463 463 463 463 463 463 463 463 463 463 463 463 463 463 463 463 463 463 463 463 463 557 558 559 463 465 407 407 407 407 407 407 407 407 
407 407 407 407 407 407 407 407 407 407 407 407 407 407 407 407 407 407 407 407 407 407 407 407 407 407 407 407 407 407 407 407 407 407 407 407 407 587 588 589 407 407 407 407 407 407 407 407 407 407 
407 407 407 407 407 407 407 407 372 373 373 373 373 373 373 373 373 373 373 373 373 373 373 373 373 373 373 373 373 373 373 373 373 373 373 373 373 677 678 679 374 375 407 407 407 407 407 407 407 407 
407 407 407 407 407 407 407 407 440 217 217 217 217 217 217 217 217 217 217 217 217 217 217 217 217 217 217 217 217 217 217 217 217 217 217 217 217 217 219 217 156 436 407 407 407 407 407 407 407 407 
407 407 407 407 407 407 407 407 440 217 217 217 217 217 217 217 217 217 217 217 217 217 217 217 217 217 217 217 217 217 217 217 217 217 217 217 217 217 217 217 217 436 407 407 407 407 407 407 407 407 
407 407 407 407 407 407 407 407 440 217 217 217 217 217 217 217 217 217 217 217 217 217 217 217 217 217 217 217 217 217 217 217 217 217 217 217 217 217 217 217 217 436 407 407 407 407 407 407 407 407 
407 407 407 407 407 407 407 407 440 217 217 217 217 217 217 217 217 217 217 217 217 217 217 217 217 217 217 217 217 217 217 217 217 217 217 217 217 217 217 217 217 436 407 407 407 407 407 407 407 407 
407 407 407 407 407 407 407 407 440 217 217 217 217 217 217 217 217 217 217 217 217 217 217 217 217 217 217 217 217 217 217 217 217 217 217 217 217 217 217 217 217 436 407 407 407 407 407 407 407 407 
407 407 407 407 407 407 407 407 440 217 217 217 217 217 217 217 217 217 217 217 217 217 217 217 217 217 217 217 217 217 217 217 217 217 217 217 217 217 217 217 217 436 407 407 407 407 407 407 407 407 
407 407 407 407 407 407 407 407 440 217 217 217 217 217 217 217 217 217 217 217 217 217 217 217 217 217 217 217 217 217 217 217 217 217 217 217 217 217 217 217 217 436 407 407 407 407 407 407 407 407 
407 407 407 407 407 407 407 407 440 217 217 217 217 217 217 217 217 217 217 217 217 217 217 217 217 217 217 217 217 217 217 217 217 217 217 217 217 217 217 217 217 436 407 407 407 407 407 407 407 407 
407 407 407 407 407 407 407 407 440 217 217 217 217 217 217 217 217 217 217 217 217 217 217 217 217 217 217 217 217 217 217 217 217 217 217 217 217 217 217 217 217 436 407 407 407 407 407 407 407 407 
407 407 407 407 407 407 407 407 440 217 217 217 217 217 217 217 217 217 217 217 217 217 217 217 217 217 217 217 217 217 217 217 217 217 217 217 217 217 217 217 217 436 407 407 407 407 407 407 407 407 
407 407 407 407 407 407 407 407 440 217 217 217 217 217 217 217 217 217 217 217 217 217 217 217 217 217 217 217 217 217 217 217 217 217 217 217 217 217 217 217 217 436 407 407 407 407 407 407 407 407 
407 407 407 407 407 407 407 407 440 217 217 217 217 217 217 217 217 217 217 217 217 217 217 217 217 217 217 217 217 217 217 217 217 217 217 217 217 217 217 217 217 436 407 407 407 407 407 407 407 407 
407 407 407 407 407 407 407 407 440 217 217 217 217 217 217 217 217 217 217 217 217 217 217 217 217 217 217 217 217 217 217 217 217 217 217 217 217 217 217 217 217 436 407 407 407 407 407 407 407 407 
407 407 407 407 407 407 407 407 440 217 217 217 217 217 217 217 217 217 217 217 217 217 217 217 217 217 217 217 217 217 217 217 217 217 217 217 217 217 217 217 217 436 407 407 407 407 407 407 407 407 
407 407 407 407 407 407 407 407 440 217 217 217 217 217 217 217 217 217 217 217 217 217 217 217 217 217 217 217 217 217 217 217 217 217 217 217 217 217 217 217 217 436 407 407 407 407 407 407 407 407 
407 407 407 407 407 407 407 407 440 217 217 217 217 217 217 217 217 217 217 217 217 217 217 217 217 217 217 217 217 217 217 217 217 217 217 217 217 217 217 217 217 436 407 407 407 407 407 407 407 407 
407 407 407 407 407 407 407 407 440 217 217 217 217 217 217 217 217 217 217 217 217 217 217 217 217 217 217 217 217 217 217 217 217 217 217 217 217 217 217 217 217 436 407 407 407 407 407 407 407 407 
407 407 407 407 407 407 407 407 440 217 217 217 217 217 217 217 217 217 217 217 217 217 217 217 217 217 217 217 217 217 217 217 217 217 217 217 217 217 217 217 217 436 407 407 407 407 407 407 407 407 
407 407 407 407 407 407 407 407 440 217 217 217 217 217 217 217 217 217 217 217 217 217 217 217 217 217 217 217 217 217 217 217 217 217 217 217 217 217 217 217 217 436 407 407 407 407 407 407 407 407 
407 407 407 407 407 407 407 407 440 217 217 217 217 217 217 217 217 217 217 217 217 217 217 217 217 217 217 217 217 217 217 217 217 217 217 217 217 217 217 217 217 436 407 407 407 407 407 407 407 407 
407 407 407 407 407 407 407 407 440 217 217 217 217 217 217 217 217 217 217 217 217 217 217 217 217 217 217 217 217 217 217 217 217 217 217 217 217 217 217 217 217 436 407 407 407 407 407 407 407 407 
407 407 407 407 407 407 407 407 440 217 217 217 217 217 217 217 217 217 217 217 217 217 217 217 217 217 217 217 217 217 217 217 217 217 217 217 217 217 217 217 217 436 407 407 407 407 407 407 407 407 
407 407 407 407 407 407 407 407 402 217 217 217 217 217 217 217 217 217 217 217 217 217 217 217 217 217 217 217 217 217 217 217 217 217 217 217 217 217 217 217 217 436 407 407 407 407 407 407 407 407 
407 407 407 407 407 407 407 407 402 217 217 217 217 217 217 217 217 217 217 217 217 217 217 217 217 217 217 217 217 217 217 217 217 217 217 217 217 217 217 217 217 436 407 407 407 407 407 407 407 407 
407 407 407 407 407 407 407 407 402 217 217 217 217 217 217 217 217 217 217 217 217 217 217 217 217 217 217 217 217 217 217 217 217 217 217 217 217 217 217 217 217 435 407 407 407 407 407 407 407 407 
407 407 407 407 407 407 407 407 402 217 217 217 217 217 217 217 217 217 217 217 217 217 217 217 217 217 217 217 217 217 217 217 217 217 217 217 217 217 217 217 217 435 407 407 407 407 407 407 407 407 
407 407 407 407 407 407 407 407 462 463 463 463 463 463 463 463 463 463 463 463 463 463 463 463 463 463 463 463 463 463 463 463 463 463 463 463 463 463 463 463 463 465 407 407 407 407 407 407 407 407 
407 407 407 407 407 407 407 407 407 407 407 407 407 407 407 407 407 407 407 407 407 407 407 407 407 407 407 407 407 407 407 407 407 407 407 407 407 407 407 407 407 407 407 407 407 407 407 407 407 407 
407 407 407 407 407 407 407 407 407 407 407 407 407 407 407 407 407 407 407 407 407 407 407 407 407 407 407 407 407 407 407 407 407 407 407 407 407 407 407 407 407 407 407 407 407 407 407 407 407 407 
407 407 407 407 407 407 407 407 407 407 407 407 407 407 407 407 407 407 407 407 407 407 407 407 407 407 407 407 407 407 407 407 407 407 407 407 407 407 407 407 407 407 407 407 407 407 407 407 407 407 
407 407 407 407 407 407 407 407 407 407 407 407 407 407 407 407 407 407 407 407 407 407 407 407 407 407 407 407 407 407 407 407 407 407 407 407 407 407 407 407 407 407 407 407 407 407 407 407 407 407 
407 407 407 407 407 407 407 407 407 407 407 407 407 407 407 407 407 407 407 407 407 407 407 407 407 407 407 407 407 407 407 407 407 407 407 407 407 407 407 407 407 407 407 407 407 407 407 407 407 407 
407 407 407 407 407 407 407 407 407 407 407 407 407 407 407 407 407 407 407 407 407 407 407 407 407 407 407 407 407 407 407 407 407 407 407 407 407 407 407 407 407 407 407 407 407 407 407 407 407 407 
