57 57 57 57 57 57 57 57 57 57 57 57 57 57 57 57 57 57 57 57 57 57 57 57 57 57 57 57 57 57 57 57 57 57 57 57 57 57 57 57 57 57 57 57 57 57 57 57 57 57 
57 57 57 57 57 57 57 57 57 57 57 57 57 57 57 57 57 57 57 57 57 57 57 57 57 57 57 57 57 57 57 57 57 57 57 57 57 57 57 57 57 57 57 57 57 57 57 57 57 57 
57 57 57 57 57 57 57 57 57 57 57 57 57 57 57 57 57 57 57 57 57 57 57 57 57 57 57 57 57 57 57 57 57 57 57 57 57 57 57 57 57 57 57 57 57 57 57 57 57 57 
57 57 57 57 57 57 57 57 57 57 57 57 57 57 57 57 57 57 57 57 57 57 57 57 57 57 57 57 57 57 57 57 57 57 57 57 57 57 57 57 57 57 57 57 57 57 57 57 57 57 
57 57 57 57 57 57 57 57 57 57 57 57 57 57 57 57 57 57 57 57 57 57 57 57 57 57 57 57 57 57 57 57 57 57 57 57 57 57 57 57 57 57 57 57 57 57 57 57 57 57 
57 57 57 57 57 57 57 57 57 57 57 57 57 57 57 57 57 57 57 57 57 57 57 57 57 57 57 57 57 57 57 57 57 57 57 57 57 57 57 57 57 57 57 57 57 57 57 57 57 57 
57 57 57 57 57 57 57 71 26 38 38 38 38 38 38 38 38 38 38 38 38 38 38 38 38 38 38 38 38 38 38 38 38 38 38 38 38 38 38 38 38 40 57 57 57 57 57 57 57 57 
57 57 57 57 57 57 57 71 60 145 146 146 146 146 146 146 146 146 146 146 146 146 146 146 146 146 146 146 146 146 146 146 165 165 165 165 165 147 148 122 122 69 57 57 57 57 57 57 57 57 
57 57 57 57 57 57 57 57 60 158 7 6 7 7 7 7 163 7 7 163 7 7 7 163 7 7 162 7 7 7 7 7 7 7 163 7 7 163 153 122 125 69 57 57 57 57 57 57 57 57 
57 57 57 57 57 57 57 71 60 158 7 7 7 7 7 7 7 7 7 7 163 7 7 7 7 7 7 7 7 7 6 7 7 7 7 7 7 7 159 122 122 69 57 57 57 57 57 57 57 57 
57 57 57 57 57 57 57 71 60 155 7 7 163 7 6 7 7 6 7 7 7 7 162 7 7 7 163 7 163 7 7 7 7 162 7 7 7 162 159 125 122 69 70 57 57 57 57 57 57 57 
57 57 57 57 57 57 57 71 60 13 14 14 14 14 14 14 14 14 14 14 14 14 14 14 14 14 14 14 14 14 14 14 14 14 14 139 163 7 159 125 125 69 70 57 57 57 57 57 57 57 
57 57 59 57 57 57 57 57 80 42 42 42 42 42 42 42 42 42 44 42 42 42 42 42 42 42 42 42 42 42 42 42 42 42 45 158 7 7 159 41 44 83 57 57 57 57 57 57 57 57 
57 57 57 57 57 57 57 58 71 71 71 71 71 58 58 58 58 58 58 58 58 58 58 58 58 58 58 58 58 58 58 58 58 58 60 158 7 7 159 69 71 71 71 57 57 57 57 57 57 57 
57 57 57 57 57 57 57 71 71 71 71 71 71 71 71 71 71 71 71 71 71 71 71 71 71 71 71 71 71 71 71 71 71 71 60 158 7 6 159 69 71 71 71 57 57 57 57 57 57 57 
57 57 57 57 57 57 57 71 26 38 38 38 38 38 38 38 38 38 38 38 38 38 38 38 38 38 38 38 38 38 38 38 38 38 88 158 7 7 159 84 38 40 58 57 57 57 57 57 57 57 
57 57 57 57 57 57 57 58 60 135 151 151 151 151 151 151 151 151 151 151 151 151 151 125 41 44 44 44 44 44 44 44 44 44 45 155 7 7 153 125 125 69 58 57 57 57 57 57 57 57 
57 57 57 57 57 57 57 58 60 135 151 135 135 135 53 135 135 135 53 135 135 135 151 135 41 71 71 71 71 71 71 71 71 71 52 155 7 7 153 151 125 69 58 57 57 57 57 57 57 57 
57 57 57 57 57 57 58 58 60 135 151 135 135 135 53 135 135 135 53 135 135 135 151 135 41 71 71 71 71 71 71 71 71 71 52 155 163 7 153 67 125 69 58 57 57 57 57 57 57 57 
57 57 57 57 57 57 58 58 60 135 151 145 146 148 53 145 146 148 53 145 146 148 151 125 41 71 71 71 71 71 71 71 71 71 52 155 7 162 153 125 125 69 58 57 57 57 57 57 57 57 
57 57 57 57 57 57 58 58 60 135 151 155 7 153 53 155 7 153 53 155 7 153 151 125 84 87 87 87 87 87 87 87 87 87 88 155 7 7 153 125 125 69 58 57 57 57 57 57 57 57 
57 57 57 57 57 57 58 58 60 145 147 166 7 164 147 166 7 164 147 166 7 164 147 165 165 165 165 165 165 165 165 165 165 165 147 166 7 7 153 125 125 69 58 57 57 57 57 57 57 57 
57 57 57 57 57 57 57 58 60 155 7 7 7 7 6 7 7 7 163 7 7 7 7 7 7 7 7 7 6 7 7 7 7 7 6 7 7 163 153 135 135 69 58 57 57 57 57 57 57 57 
57 57 57 57 57 57 57 58 60 155 7 163 7 7 7 7 7 6 7 7 7 163 7 7 7 6 7 7 7 7 7 163 7 7 7 7 7 7 153 135 125 69 58 57 57 57 57 57 57 57 
57 57 57 57 57 57 57 58 60 13 15 15 15 15 15 15 15 15 15 15 15 15 15 15 15 15 15 138 138 138 138 138 138 138 138 139 7 7 153 135 135 56 58 57 57 57 57 57 57 57 
57 57 57 57 57 57 57 58 80 43 81 43 81 43 43 43 81 81 81 81 81 81 43 43 43 81 81 81 81 81 81 81 81 43 45 155 7 6 153 41 81 83 58 57 57 57 57 57 57 57 
57 57 57 57 57 57 57 58 57 57 57 57 57 57 57 57 57 57 57 57 57 57 57 57 57 57 57 57 59 59 59 59 59 59 65 155 7 7 153 68 72 72 72 58 57 57 57 57 57 57 
57 57 57 57 57 57 57 58 26 38 38 38 38 38 38 38 38 38 38 38 38 38 38 38 38 38 38 38 38 38 38 38 38 38 88 155 6 7 153 84 38 40 58 57 57 57 57 57 57 57 
57 57 57 57 57 57 57 58 60 53 125 125 125 125 125 125 125 125 125 125 125 125 125 125 125 125 125 125 125 125 125 125 135 125 125 155 7 7 153 135 135 56 58 57 57 57 57 57 57 57 
57 57 57 57 57 57 57 58 60 125 125 125 125 125 125 108 125 125 53 125 125 125 108 125 125 136 125 125 125 108 125 53 125 125 135 13 14 15 16 125 125 56 58 57 57 57 57 57 57 57 
57 57 57 57 57 57 57 58 60 125 125 136 125 125 125 125 125 125 125 125 136 125 125 125 125 125 125 125 125 125 136 125 125 125 125 125 125 125 135 125 125 69 58 57 57 57 57 57 57 57 
57 57 57 57 57 57 57 58 60 108 125 125 125 125 125 125 136 125 125 125 125 125 125 125 125 125 136 125 125 125 125 125 125 125 125 125 125 125 125 136 125 69 58 57 57 57 57 57 57 57 
57 57 57 57 57 57 57 58 60 125 125 125 53 125 125 125 125 125 125 125 125 125 125 125 53 125 125 125 125 108 125 125 125 125 135 108 135 135 53 125 125 69 58 57 57 57 57 57 57 57 
57 57 57 57 57 57 57 58 60 125 125 125 125 125 125 108 125 125 125 135 135 136 125 125 125 108 125 125 125 125 125 125 53 125 125 135 135 135 135 125 125 69 58 57 57 57 57 57 57 57 
57 57 57 57 57 57 58 58 60 125 125 125 136 125 125 136 125 135 136 135 135 53 135 135 135 135 136 135 135 53 125 125 125 125 136 135 53 135 135 125 125 69 58 57 57 57 57 57 57 57 
57 57 57 57 57 57 58 58 60 125 125 125 125 125 125 125 135 135 125 125 125 125 125 125 125 125 125 125 135 135 135 135 135 135 135 135 135 135 125 125 125 69 58 57 57 57 57 57 57 57 
57 57 57 57 57 57 58 58 60 125 53 125 125 125 125 135 135 125 125 125 125 125 125 108 136 125 125 125 125 125 125 125 125 108 135 135 135 125 136 125 125 69 58 57 57 57 57 57 57 57 
57 57 57 57 57 57 58 58 60 125 125 135 135 125 108 135 53 125 125 125 125 125 125 125 125 125 53 125 125 125 125 125 125 125 135 125 125 125 135 125 125 69 58 57 57 57 57 57 57 57 
57 57 57 57 57 57 57 58 60 125 136 135 135 135 135 125 125 125 125 136 125 125 125 125 125 125 125 136 125 125 125 136 125 125 136 135 135 135 108 125 125 69 58 58 57 57 57 57 57 57 
57 57 57 57 57 57 57 58 60 125 135 135 135 135 136 125 125 125 108 125 125 125 125 125 125 125 108 125 125 125 125 125 125 125 135 135 135 135 135 135 125 69 58 58 57 57 57 57 57 57 
57 57 57 57 57 57 57 58 60 125 136 135 135 125 125 125 125 125 125 125 125 125 125 136 125 125 125 125 125 125 135 135 53 135 135 135 135 136 135 135 125 69 58 57 57 57 57 57 57 57 
57 57 57 57 57 57 57 58 60 125 125 125 108 125 125 53 125 125 125 136 53 125 125 125 125 125 135 135 53 135 135 125 125 136 135 136 135 53 135 135 125 69 58 57 57 57 57 57 57 57 
57 57 57 57 57 57 57 58 60 125 125 125 125 125 125 125 125 125 125 125 125 125 108 125 125 125 125 135 136 135 108 135 135 135 135 136 135 135 135 125 54 69 58 57 57 57 57 57 57 57 
57 57 57 57 57 57 57 58 80 81 81 81 81 81 81 81 81 81 81 81 81 81 81 81 81 81 81 81 81 81 81 81 81 81 81 81 81 81 81 81 81 83 58 57 57 57 57 57 57 57 
57 57 57 57 57 57 57 57 57 57 57 70 70 70 70 70 57 57 57 57 57 57 57 57 57 57 57 57 57 57 57 57 57 57 57 57 57 57 57 57 57 57 57 57 57 57 57 57 57 57 
57 57 57 57 57 57 57 57 57 57 57 57 57 57 57 57 57 57 57 57 57 57 57 57 57 57 57 57 57 57 57 57 57 57 57 57 57 57 57 57 57 57 57 57 57 57 57 57 57 57 
57 57 57 57 57 57 57 57 57 57 57 57 57 57 57 57 57 57 57 57 57 57 57 57 57 57 57 57 57 57 57 57 57 57 57 57 57 57 57 57 57 57 57 57 57 57 57 57 57 57 
57 57 57 57 57 57 57 57 57 57 57 57 57 57 57 57 57 57 57 57 57 57 57 57 57 57 57 57 57 57 57 57 57 57 57 57 57 57 57 57 57 57 57 57 57 57 57 57 57 57 
57 57 57 57 57 57 57 57 57 57 57 57 57 57 57 57 57 57 57 57 57 57 57 57 57 57 57 57 57 57 57 57 57 57 57 57 57 57 57 57 57 57 57 57 57 57 57 57 57 57 
57 57 57 57 57 57 57 57 57 57 57 57 57 57 57 57 57 57 57 57 57 57 57 57 57 57 57 57 57 57 57 57 57 57 57 57 57 57 57 57 57 57 57 57 57 57 57 57 57 57 
